-5
[15, 10]
[7, 8]
L
Wine Cellar
You emerge out of the sewers into a dusky wine cellar filled with spider webs and several barrels of wine.
;	-	-	-	-	-	-	n	-	-	-	-	-	-	'
|	n	n	n	n	n	n	n	n	n	n	n	n	n	|
|	n	n	n	n	n	n	n	n	n	n	n	n	n	|
|	n	n	n	n	n	n	n	n	n	n	n	n	n	|
|	n	n	n	n	n	n	n	n	n	n	n	n	n	n
|	n	n	n	n	n	n	n	n	n	n	n	n	n	|
|	n	n	n	n	n	n	n	n	n	n	n	n	n	|
|	n	n	n	n	n	n	n	n	n	n	n	n	n	|
|	n	n	n	n	n	n	n	n	n	n	n	n	n	|
,	-	-	-	-	-	-	n	-	-	-	-	-	-	.
