-22
[16,12]
[1,6]
L
Moat
Almost there
;	-	-	-	-	-	-	-	-	L	R	-	-	-	-	'
n	n	n	n	|	|	n	n	n	L	R	n	n	n	|	|
m	n	n	n	|	|	n	n	n	L	R	n	n	n	|	|
m	n	n	n	|	|	n	n	n	L	R	n	n	n	|	|
m	n	n	n	|	|	n	n	n	L	R	n	n	n	n	n
m	n	n	n	|	|	n	n	n	L	R	n	n	n	|	|
n	n	n	n	|	|	n	n	n	L	R	n	n	n	|	|
m	n	n	n	|	|	n	n	n	L	R	n	n	n	|	|
m	n	n	n	|	|	n	n	n	L	R	n	n	n	|	|
m	n	n	n	|	|	n	n	n	L	R	n	n	n	|	|
m	n	n	n	n	n	n	n	n	L	R	n	n	n	|	|
|	-	-	-	-	-	-	-	-	L	R	-	-	-	.	.

